4 4 4 4 4 4 4 4 4 4 4 4 4 4 4 4 4 4 4 4 4 4 4 4 4 4 4 4 4 4 4 4 4 4 4 4 4 4 4 4 4 4 4 4 4 4 4 4 4 4 4 4 4 4 4 4 4 4 4 4 4 4 4 4 4 4 4 4 4 4 4 4 4 4 4 4 4 4 4 4 4 4 4 4 4 4 4 4 4 4 4
1 1 1 1 1 1 1 1 1 1 1 1 1 1 4 4 4 4 4 4 4 4 4 4 4 4 4 4 4 4 4 4 4 4 4 4 4 4 4 4 4 4 4 4 4 4 4 4 4 4 4 4 4 4 4 4 4 4 4 4 4 4 4 4 4 4 4 4 4 4 4 4 4 4 4 4 4 4 4 4 4 4 4 4 4 1 1 1 1 1 4
1 1 1 1 1 1 1 1 1 1 1 1 1 1 1 1 1 1 1 1 1 4 1 1 1 4 1 1 1 1 1 1 1 1 4 1 1 1 1 1 1 1 1 1 1 1 1 1 1 1 1 4 1 1 1 1 1 1 1 1 1 1 1 1 1 1 4 1 1 1 1 1 1 1 1 1 1 1 1 1 1 1 4 1 4 4 4 1 1 1 4
1 1 1 1 1 1 1 1 1 1 1 1 1 1 1 1 1 1 1 1 1 4 1 1 1 4 82 1 1 1 1 1 1 1 4 1 1 1 1 1 1 1 1 1 255 1 1 81 255 1 1 4 1 1 1 1 1 1 1 1 1 1 1 1 1 1 1 1 1 1 1 1 1 1 1 1 1 1 255 1 1 1 4 1 1 1 4 4 4 1 4
1 1 1 1 1 1 1 1 1 1 1 1 1 1 4 1 1 1 1 1 1 4 1 1 1 4 1 1 1 1 1 1 1 1 4 1 1 1 1 1 1 1 1 1 255 255 255 255 255 1 1 4 1 1 1 1 1 1 1 1 1 1 1 1 1 1 4 1 1 1 1 1 1 1 1 1 1 1 255 1 1 1 4 1 1 1 1 1 4 1 4
1 1 1 1 1 1 1 1 1 1 1 1 1 1 1 1 1 1 1 1 1 4 1 1 1 4 1 1 1 1 1 1 1 1 4 1 1 4 1 1 1 1 1 1 1 1 1 1 1 1 1 4 1 1 4 1 1 82 1 1 1 1 1 1 1 1 4 1 1 1 4 1 1 1 1 1 1 1 255 255 255 1 4 1 1 82 1 1 4 4 4
1 1 1 1 1 1 1 1 1 1 1 1 1 1 1 1 1 1 1 1 1 4 1 1 1 4 1 1 1 1 1 1 1 1 4 1 1 4 1 1 1 1 1 1 1 1 1 1 1 1 1 1 1 1 4 1 1 1 1 1 1 255 255 255 255 1 4 1 1 1 4 1 1 1 1 1 1 1 1 1 1 1 4 1 1 1 1 1 1 4 4
1 1 1 1 1 1 1 1 1 1 1 1 1 1 4 1 1 1 1 1 1 4 1 1 1 4 1 1 1 1 1 1 1 1 4 1 1 4 4 1 1 1 1 1 1 1 1 1 1 1 1 4 1 1 4 4 1 1 1 1 1 255 1 82 1 1 4 1 1 1 4 4 1 1 1 1 1 1 1 1 1 1 4 1 1 1 1 1 1 4 4
1 1 1 1 1 1 1 1 1 1 1 1 1 1 4 4 1 4 1 4 1 4 1 1 1 4 1 1 1 1 1 1 1 1 4 1 1 4 4 4 1 1 1 1 1 1 1 1 1 1 1 4 1 1 4 4 4 1 1 1 1 1 1 1 1 1 4 1 1 1 4 4 4 1 1 1 1 1 1 1 1 1 4 1 1 1 1 1 1 1 4
1 1 1 1 1 1 1 1 1 1 1 1 1 1 4 1 1 1 1 1 1 4 4 1 4 4 4 4 1 1 1 1 4 4 4 1 4 4 4 4 4 4 4 4 4 4 4 4 4 4 4 4 1 4 4 4 4 4 4 4 4 4 4 4 4 4 4 1 1 4 4 4 4 4 1 1 1 1 1 1 1 1 1 1 1 1 1 1 1 1 4
1 1 1 1 1 1 1 1 1 1 1 1 1 1 4 1 1 1 1 1 1 1 1 1 1 1 1 1 1 1 1 1 1 1 1 1 1 1 1 1 1 1 1 1 1 1 1 1 1 1 1 1 1 1 1 1 1 1 1 1 1 1 4 1 1 1 1 1 1 1 1 1 1 4 1 1 1 1 1 1 1 1 4 1 1 1 1 1 1 1 4
1 1 1 1 1 1 1 1 1 1 1 1 1 1 4 1 1 1 1 1 1 1 1 1 1 1 1 1 1 1 1 1 1 1 1 1 1 1 1 1 1 1 1 1 1 1 1 1 1 1 1 1 1 1 1 1 1 1 1 1 1 1 4 1 1 1 1 1 1 1 1 1 1 4 1 1 1 1 1 1 1 1 4 1 1 1 1 1 1 4 4
1 1 1 1 1 1 1 1 1 1 1 1 1 1 4 4 1 1 1 1 1 1 1 1 1 1 1 1 1 1 1 1 1 1 1 1 1 1 1 1 1 1 1 1 1 1 1 1 1 1 1 1 1 1 1 1 1 1 1 1 1 1 4 1 1 1 1 1 1 1 1 1 1 4 1 1 1 1 1 1 1 1 4 1 1 1 1 1 1 4 4
1 1 1 1 1 1 1 1 1 1 1 1 1 1 4 4 4 1 1 1 1 1 1 1 1 1 1 1 1 1 1 1 1 1 1 1 1 1 1 1 1 1 1 1 1 1 1 1 1 1 1 1 1 1 1 1 1 1 1 1 1 1 4 1 1 1 1 1 1 1 1 1 1 4 1 1 1 1 1 1 1 1 4 1 1 1 1 1 4 4 4
1 1 1 1 1 1 1 1 1 1 1 1 1 1 4 4 4 4 4 4 4 4 4 1 4 4 4 4 4 4 4 4 4 1 1 1 1 4 4 1 4 4 4 4 4 4 4 4 4 4 4 4 4 4 4 1 1 1 1 4 4 4 4 4 4 4 4 4 4 1 1 1 1 4 1 1 1 1 1 1 1 1 4 1 1 1 1 1 4 1 4
1 1 1 1 1 1 1 1 1 1 1 1 1 1 4 1 1 1 1 1 1 1 1 1 1 1 1 1 1 1 1 1 4 1 1 1 1 4 4 1 1 1 1 1 4 4 1 1 1 1 1 1 4 4 4 1 1 1 1 4 4 4 1 1 1 1 1 1 4 1 1 1 1 4 1 1 1 1 1 1 1 1 4 1 1 1 4 4 4 1 4
1 1 1 1 1 1 1 1 1 1 1 1 1 1 4 1 1 1 1 1 1 1 1 1 1 1 1 1 1 1 1 1 4 1 1 1 1 4 4 1 1 1 1 1 4 4 1 1 1 1 1 1 1 4 4 1 1 1 1 4 4 82 1 1 255 1 1 1 1 1 1 1 1 4 1 1 1 1 1 1 1 1 4 81 4 4 4 1 1 1 4
1 1 1 1 1 1 1 1 1 1 1 1 1 1 4 1 1 4 4 4 4 4 1 1 1 4 4 4 4 4 1 1 4 1 1 1 1 4 4 4 1 1 1 1 4 4 1 1 1 1 1 1 1 1 4 1 1 1 1 4 1 1 1 1 255 1 1 1 1 1 1 1 1 4 4 4 4 4 4 4 1 1 4 4 4 1 1 1 1 1 4
1 1 1 1 1 1 1 1 1 1 1 1 1 1 4 1 1 1 1 4 1 1 1 1 1 1 1 4 1 1 1 1 4 1 1 1 1 4 4 4 4 4 4 4 4 4 1 82 1 1 1 1 82 1 4 1 1 1 1 4 1 1 1 1 255 1 1 1 4 1 1 1 1 4 4 4 4 4 4 4 1 1 4 1 1 1 1 1 1 1 4
1 1 1 1 1 1 1 1 1 1 1 1 1 1 4 1 1 1 1 4 1 1 1 1 1 1 1 4 1 1 1 1 4 1 1 1 1 1 1 1 1 1 1 1 4 4 1 1 1 1 1 1 1 1 4 1 1 1 1 4 1 255 255 255 255 1 1 1 4 1 1 1 1 4 1 1 1 1 1 1 1 1 4 1 1 1 1 1 1 1 4
1 1 1 1 1 1 1 1 1 1 1 1 1 1 4 1 1 1 1 4 1 1 1 1 1 1 1 4 1 1 1 1 4 1 1 1 1 4 4 4 4 4 1 1 4 4 1 1 1 1 1 1 1 1 4 1 1 1 1 4 1 1 1 1 1 1 1 1 4 1 1 1 1 4 1 1 1 1 1 1 1 1 4 1 1 1 1 1 1 1 4
1 1 1 1 1 1 1 1 1 1 1 1 1 1 4 1 1 4 4 4 4 4 1 1 1 4 4 4 4 4 1 1 4 1 1 1 1 4 82 1 1 1 1 1 4 4 1 1 1 1 1 1 1 1 4 1 1 1 1 4 1 1 1 1 1 1 1 1 4 1 1 1 1 4 255 255 255 255 1 1 1 1 4 1 1 1 1 1 1 1 4
1 1 1 1 1 1 1 1 1 1 1 1 1 1 4 1 1 82 1 4 1 1 1 1 1 1 1 4 1 1 1 1 4 1 1 1 1 4 1 1 1 4 1 1 1 1 1 1 1 1 1 1 1 1 4 1 1 1 1 4 1 1 1 1 1 1 1 1 4 1 1 1 1 4 4 1 82 1 1 1 1 1 4 1 1 1 1 1 1 1 4
1 1 1 1 1 1 1 1 1 1 1 1 1 1 4 1 1 1 1 4 1 1 1 1 1 1 1 4 1 1 1 1 4 1 1 1 1 4 4 4 4 4 1 81 1 1 1 1 1 1 1 1 1 1 1 1 1 1 1 4 1 1 1 1 1 1 1 1 4 1 1 1 1 4 4 4 1 1 1 1 1 1 4 1 1 1 1 1 1 1 4
1 1 1 1 1 1 1 1 1 1 1 1 1 1 4 1 1 1 1 4 1 1 1 1 1 1 1 4 1 1 1 1 4 1 1 1 1 4 4 4 4 4 1 1 4 4 81 1 1 1 1 1 1 1 1 1 1 1 1 4 1 1 1 1 1 1 1 1 4 1 1 1 1 4 4 4 4 4 4 1 1 1 4 1 1 1 1 1 1 1 4
1 1 1 1 1 1 1 1 1 1 1 1 1 1 4 1 1 4 4 4 4 4 1 1 1 4 4 4 4 4 1 1 1 1 1 1 1 4 1 1 1 1 1 1 4 4 4 4 4 4 4 4 4 4 4 1 1 1 1 4 1 1 1 1 1 1 1 1 4 1 1 1 1 4 1 1 1 1 1 1 1 1 4 1 1 1 1 1 1 1 4
1 1 1 1 1 1 1 1 1 1 1 1 1 1 4 1 1 1 1 4 1 1 1 1 1 1 1 4 1 1 1 1 4 1 1 1 1 4 1 1 1 4 1 1 4 4 1 1 1 1 1 1 1 1 1 1 1 1 1 4 1 1 1 1 1 1 1 1 4 1 1 1 1 1 1 1 1 1 1 1 1 1 4 1 1 1 1 1 1 1 4
1 1 1 1 1 1 1 1 1 1 1 1 1 1 4 1 1 1 1 4 1 1 1 1 1 1 1 4 1 1 1 1 4 1 1 1 4 4 4 4 4 4 4 1 4 4 1 1 1 1 1 1 1 1 1 1 1 1 1 4 1 1 1 1 1 1 1 1 4 1 1 1 1 4 4 4 4 4 4 4 4 4 4 1 1 1 1 1 1 1 4
1 1 1 1 1 1 1 1 1 1 1 1 1 1 4 1 1 1 1 4 1 1 1 1 1 1 1 4 1 1 1 1 4 1 1 1 4 1 1 1 1 1 1 1 4 4 1 1 1 1 1 1 1 1 4 1 1 1 1 4 1 1 1 1 1 1 1 1 4 1 1 1 1 4 1 1 1 1 1 1 1 82 4 1 1 1 1 1 1 1 4
1 1 1 1 1 1 1 1 1 1 1 1 1 1 4 1 1 4 4 4 4 4 1 1 1 4 4 4 4 4 1 1 4 1 1 1 4 4 4 4 4 4 1 1 4 4 1 1 1 1 1 1 1 1 4 1 1 1 1 4 1 1 1 1 1 1 1 1 4 1 1 1 1 4 1 1 1 1 1 1 1 1 4 1 1 1 1 1 1 1 4
1 1 1 1 1 1 1 1 1 1 1 1 1 1 4 1 1 1 1 4 1 1 1 1 1 1 1 4 1 1 1 1 4 1 1 1 4 4 1 1 1 1 1 1 4 4 1 1 1 1 1 1 1 1 4 1 1 1 1 4 1 1 1 1 1 1 1 1 4 1 1 1 1 4 1 1 1 1 1 1 1 1 4 1 1 1 1 1 1 1 4
1 1 1 1 1 1 1 1 1 1 1 1 1 1 4 1 1 1 1 4 1 1 1 1 1 1 1 4 1 1 1 1 4 1 1 1 1 4 1 1 1 4 1 1 4 4 1 1 1 1 1 1 1 1 4 1 1 1 1 4 1 1 1 1 1 1 1 1 4 1 1 1 1 4 1 1 4 1 1 1 1 1 4 1 1 1 1 1 1 1 4
1 1 1 1 1 1 1 1 1 1 1 1 1 1 4 1 1 1 1 4 1 1 1 1 255 1 81 4 1 1 1 1 4 1 1 1 1 4 4 4 4 4 1 81 4 4 1 1 1 1 1 1 1 1 4 1 1 1 1 4 1 1 1 1 255 255 255 1 4 1 1 1 1 4 1 1 4 1 1 1 1 1 4 1 1 1 1 1 1 1 4
1 1 1 1 1 1 1 1 1 1 1 1 1 1 4 1 1 4 4 4 4 4 1 1 255 4 4 4 4 4 1 1 4 1 1 1 1 4 4 4 4 4 1 1 4 4 1 1 1 255 255 255 1 1 4 1 1 1 1 1 1 1 1 1 255 82 1 1 4 1 1 1 1 4 1 1 4 1 1 1 1 1 4 1 1 1 1 1 1 1 4
1 1 1 1 1 1 1 1 1 1 1 1 1 1 4 1 1 1 1 1 1 1 1 1 1 1 1 1 1 1 1 1 4 1 1 1 1 4 1 1 1 1 1 1 4 4 1 1 1 255 82 1 1 4 4 1 1 1 1 1 1 1 1 1 255 1 1 4 4 1 1 1 1 4 1 1 4 4 82 1 1 81 4 1 1 1 1 1 1 1 4
1 1 1 1 1 1 1 1 1 1 1 1 1 1 4 1 1 1 1 1 1 1 4 4 4 4 1 1 1 1 1 1 4 1 1 1 1 4 1 1 1 4 1 1 4 4 1 1 1 1 1 1 4 4 4 1 1 1 1 4 82 1 1 1 1 1 4 4 4 1 1 1 1 4 1 1 4 4 4 1 1 1 4 1 1 1 1 1 1 1 4
1 4 4 4 4 4 4 4 4 4 4 4 4 4 4 4 4 4 4 4 4 4 4 1 4 4 4 4 4 4 4 4 4 1 1 1 1 4 4 4 4 4 4 1 4 4 4 4 4 4 4 4 4 4 4 4 4 4 4 4 4 4 4 4 4 4 4 4 4 1 1 1 1 4 1 4 4 4 4 1 4 4 4 1 1 1 1 1 1 1 4
1 4 1 1 1 1 1 1 1 1 1 1 1 1 1 1 1 1 1 1 1 1 1 1 1 1 1 1 1 1 1 1 1 1 1 1 1 1 1 1 1 1 4 1 1 1 1 1 1 1 1 1 1 1 1 1 1 1 1 1 1 1 1 1 1 1 1 1 1 1 1 1 1 4 1 1 1 1 1 1 1 1 4 1 1 1 1 1 1 1 4
1 4 1 1 1 1 1 1 1 1 1 1 1 1 1 1 1 1 1 1 1 1 1 1 1 1 1 1 1 1 1 1 1 1 1 1 1 1 1 1 1 1 4 1 1 1 1 1 1 1 1 1 1 1 1 1 1 1 1 1 1 1 1 1 1 1 1 1 1 1 1 1 1 4 1 1 1 1 1 1 1 1 4 1 1 1 1 1 1 1 4
1 4 1 1 1 1 1 1 1 1 1 1 1 1 1 1 1 1 1 1 1 1 1 1 1 1 1 1 1 1 1 1 1 1 1 1 1 1 1 1 1 1 4 1 1 1 1 1 1 1 1 1 1 1 1 1 1 1 1 1 1 1 1 1 1 1 1 1 1 1 1 1 1 1 4 1 1 1 1 1 1 1 4 1 1 1 1 1 1 1 4
1 4 1 1 1 1 1 1 1 1 1 1 1 1 1 1 1 1 1 1 1 1 1 1 1 1 1 1 1 1 1 1 1 1 1 1 1 1 1 1 1 1 4 1 1 1 1 1 1 1 1 1 1 1 1 1 1 1 1 1 1 1 1 1 1 1 1 1 1 1 1 1 1 1 4 1 1 1 1 1 1 1 4 1 1 1 1 1 1 1 4
1 4 1 4 4 4 4 4 4 4 4 1 4 4 4 4 4 4 4 4 1 4 4 4 4 4 4 4 4 1 4 4 4 4 4 4 4 4 1 4 4 4 4 4 4 4 4 1 4 4 4 4 4 4 4 4 1 4 4 4 4 4 4 4 4 1 4 4 4 4 4 4 4 4 1 4 4 4 4 4 4 1 4 1 1 1 1 1 1 1 4
1 4 1 1 4 4 4 1 1 1 4 1 1 4 4 4 1 1 1 4 1 1 4 4 4 1 1 1 4 1 1 4 4 4 1 1 1 4 1 1 4 4 4 1 1 1 4 1 1 4 4 4 1 1 1 4 1 1 4 4 4 1 1 1 4 1 1 4 4 4 1 1 1 4 1 1 4 4 4 1 1 1 4 1 1 1 1 1 1 1 4
1 4 1 1 4 4 1 1 1 1 4 1 1 4 4 1 1 1 1 4 1 1 4 4 1 1 1 82 4 1 1 4 4 1 1 1 1 4 1 1 4 4 1 1 1 1 4 1 1 4 4 1 1 1 82 4 1 1 4 4 1 1 1 1 4 1 1 4 4 1 1 1 1 4 1 1 4 4 1 1 1 81 4 1 1 1 1 1 1 1 4
1 4 1 1 4 1 1 1 1 1 4 1 1 4 1 1 1 1 1 4 1 1 4 1 1 1 1 1 4 1 1 4 1 1 1 1 1 4 1 1 4 1 1 81 255 1 4 1 1 4 1 1 1 1 1 4 1 1 4 1 1 255 1 1 4 1 1 4 1 1 1 1 1 4 1 1 4 1 1 1 1 1 4 1 1 1 1 1 1 1 4
1 4 1 1 4 1 1 1 1 1 4 1 1 4 82 255 255 255 1 4 1 1 4 1 1 1 1 1 4 1 1 4 1 1 1 1 1 4 1 1 4 1 255 255 255 1 4 1 1 4 1 1 1 1 1 4 1 1 4 1 1 255 255 1 4 1 1 4 1 1 1 1 1 4 1 1 4 1 1 1 1 1 4 1 1 1 1 1 1 1 4
1 4 1 1 4 1 1 1 1 1 4 1 1 4 1 1 1 1 1 4 1 1 4 1 1 1 1 1 4 1 1 4 1 1 1 1 1 4 1 1 4 1 1 1 1 1 4 1 1 4 1 1 1 1 1 4 1 1 4 1 1 1 1 1 4 1 1 4 1 1 1 1 1 4 1 1 4 1 1 1 1 1 4 1 1 1 1 1 1 1 4
1 4 1 1 1 1 1 1 1 1 4 1 1 1 1 1 1 1 1 4 1 1 1 1 1 1 1 1 4 1 1 1 1 1 1 1 1 4 1 1 1 1 1 1 1 1 4 1 1 1 1 1 1 1 1 4 1 1 1 1 1 1 1 1 4 1 1 1 1 1 1 1 1 4 1 1 1 1 1 1 1 1 4 1 1 1 1 1 1 1 4
1 4 1 1 1 1 1 1 1 1 4 1 1 1 1 1 1 82 1 1 1 1 1 1 1 1 1 1 4 1 1 1 1 1 1 1 1 4 1 1 1 1 1 82 1 82 4 1 1 1 1 1 1 1 1 4 1 1 1 1 1 1 1 1 4 1 1 1 1 1 1 82 1 1 1 1 1 1 1 1 82 1 4 1 1 1 1 1 1 1 4
1 4 1 1 1 1 1 1 1 1 4 1 1 1 1 1 1 1 81 4 1 1 1 1 1 82 1 1 4 1 1 1 1 1 1 1 1 4 1 1 1 1 1 1 1 1 1 1 1 1 1 1 1 1 1 4 1 1 1 1 1 1 1 1 4 1 1 1 1 1 1 1 1 4 1 1 1 1 1 1 1 1 4 1 1 1 1 1 1 1 4
4 4 4 4 4 4 4 4 4 4 4 4 4 4 4 4 4 4 4 4 4 4 4 4 4 4 4 4 4 4 4 4 4 4 4 4 4 4 4 4 4 4 4 4 4 4 4 4 4 4 4 4 4 4 4 4 4 4 4 4 4 4 4 4 4 4 4 4 4 4 4 4 4 4 4 4 4 4 4 4 4 4 4 4 4 4 4 4 4 4 4
